000000000000000000000000000000000000000000000000000000000000
000000000000000000000000000000000000000000000000000000000000
000000000000000000000000000000000000000000000000000000000000
000   #########   ###      ###   #####################   000
000   #########   ###      ###   ##################### h 000
000   #########   ###      ###   #####################   000
000###000   000   000###000   000###000   000###000      000
000###000   000   000###000   000###000   000###000      000
000###000   000   000###000   000###000   000###000      000
000   ###   ######      ###      ###      #########   ###000
000   ###   ######      ###    e ###      #########   ###000
000   ###   ######      ###      ###      #########   ###000
000###000###000###000   000###000###000   000   000###   000
000###000###000###000 e 000###000###000   000   000###   000
000###000###000###000   000###000###000   000   000###   000
000   #########   ###   ###      ##################      000
000   #########   ###   ###    h ##################    m 000
000   #########   ###   ###      ##################      000
000   000   000###000###000###000   000   000   000   ###000
000   000   000###000###000###000   000   000   000   ###000
000   000   000###000###000###000   000   000   000   ###000
000   ###      ###      ###   ###   ######         ###   000
000 p ### m    ###      ###   ###   ######         ###   000
000   ###      ###      ###   ###   ######         ###   000
000000000000000000000000000000000000000000000000000000000000
000000000000000000000000000000000000000000000000000000000000
000000000000000000000000000000000000000000000000000000000000